████+█       ███
█    █ ████  █ █
█ ██ █ ███████ █
█ █  █         █
███ ██ ████ ██ █
               █
███████████ ████
████ █       ███
█    █ ████  █ █
█ ██ █ ███████ █
█ █  █         █
███ ██ ████ ██ █
               █
██ █████████████
██ █ █       ███
█    █ ████  █ █
█ ██ █ ███████ █
█ █  █         █
███ ██ ████ ██ █
               █
█ ██████████████
█ ██ █       ███
█    █ ████  █ █
█ ██ █ ███████ █
█ █  █         █
███ ██ ████ ██ █
               █
██████████ █████
████ █       ███
█    █ ██ █  █ █
█ ██ █ ███████ █
= █  █         █
███ ██ ████ ██ █
               █
████████████████